16 3 3 3 3 3 3 3 3 3 3 3 3 3 3 3 3 3 15 0 2 0 0 0 11 9 9 9 9 9 9 9 9 9 9 9 9 9 9 9 9 9 9 10 0 0 0
5 7 3 3 3 3 3 3 3 14 3 3 3 3 3 3 3 8 6 0 2 0 0 11 13 14 3 3 3 3 3 3 3 3 3 3 3 3 3 3 3 3 3 12 9 10 0
0 5 4 4 7 3 3 3 3 3 3 3 3 3 8 4 4 6 0 2 0 11 9 13 3 3 3 3 0 0 0 0 0 3 3 3 3 3 3 3 3 3 14 3 3 12 10
0 0 0 0 5 4 4 4 4 4 4 4 4 4 6 0 0 0 0 2 0 5 7 3 3 3 3 0 0 0 0 0 0 0 0 0 3 3 3 3 3 3 3 3 3 8 6
0 0 0 0 0 0 0 0 0 0 0 0 0 0 0 0 0 0 0 2 0 0 5 4 7 3 3 3 3 3 3 3 0 0 0 0 0 3 3 3 3 3 3 8 4 6 0
0 0 2 0 0 0 0 0 0 0 2 0 0 0 0 0 0 0 0 2 0 0 0 0 5 4 7 3 3 3 3 3 3 3 3 3 3 3 3 3 8 4 4 6 0 0 0
0 0 0 0 0 0 2 0 0 0 0 0 0 1 0 0 0 0 0 2 0 0 0 0 0 0 5 4 7 3 3 3 3 3 3 3 3 3 8 4 6 0 0 0 0 0 0
0 0 0 0 0 1 0 0 0 0 0 0 0 0 0 0 0 0 0 2 0 0 0 0 0 0 0 0 5 4 4 4 4 4 4 4 4 4 6 0 0 0 0 0 0 0 0
0 0 0 2 0 0 0 0 2 0 0 0 0 0 0 0 0 0 0 2 0 0 0 0 0 0 0 0 0 0 0 0 0 0 0 0 0 0 0 0 0 0 0 0 0 0 0 
0 0 0 0 0 0 2 0 0 0 2 2 2 2 0 0 2 2 2 2 0 0 0 0 0 0 0 2 0 0 0 0 0 0 0 0 0 0 0 0 0 0 2 0 0 0 0
0 0 0 0 0 0 0 0 0 0 2 0 0 0 0 0 0 0 0 2 1 0 0 2 0 0 0 0 0 0 0 0 0 0 0 0 2 0 0 0 0 0 0 0 0 0 0
0 0 0 0 0 0 0 0 0 0 2 0 1 0 0 0 0 0 0 2 0 0 0 0 0 0 0 0 0 0 0 0 0 0 0 0 0 0 0 0 0 0 0 0 0 0 0
0 0 0 2 0 0 0 0 0 0 2 0 0 0 0 0 0 1 0 2 0 0 0 0 0 0 0 0 0 0 2 0 0 0 0 0 0 0 0 0 2 0 0 0 0 0 0
0 0 0 0 0 0 2 0 0 0 2 0 0 0 0 0 0 0 0 2 0 0 0 0 2 0 0 0 0 0 0 0 0 0 0 0 0 0 0 0 0 0 0 0 0 0 0
0 0 0 0 0 0 0 0 0 0 2 2 2 2 2 2 2 2 2 2 0 0 0 0 0 0 0 0 0 0 0 0 0 0 0 0 0 0 0 0 0 0 0 0 0 0 0
0 0 11 9 9 9 10 0 0 0 0 0 0 0 0 0 0 0 0 0 0 0 0 0 0 0 0 0 0 11 9 9 9 9 9 9 9 9 9 9 9 10 0 0 2 1 0
0 11 13 3 3 3 12 10 0 0 0 2 0 0 0 0 0 0 0 0 0 0 2 0 0 0 0 0 11 13 3 3 3 3 3 3 3 3 3 3 3 12 10 0 0 0 0
0 16 3 3 3 3 3 15 0 2 0 0 0 2 0 0 0 2 0 0 0 0 0 0 11 9 9 9 13 3 3 3 3 3 3 3 3 3 3 3 3 3 12 9 9 10 0
0 16 3 3 3 3 3 15 0 0 0 0 0 0 0 0 0 0 0 0 0 11 9 9 13 3 3 3 3 3 3 3 3 3 3 3 3 0 0 0 0 0 3 14 3 15 0
1 5 7 3 3 3 8 6 0 0 0 2 0 0 0 2 1 0 0 0 11 13 3 3 3 3 3 3 3 3 3 3 3 3 3 3 0 0 2 0 0 0 0 3 3 15 0
0 0 5 4 4 4 6 0 0 2 0 0 0 0 0 0 0 0 11 9 13 3 3 3 3 3 3 3 3 3 3 3 3 3 3 0 0 0 0 0 0 0 0 0 3 15 0
0 0 0 0 0 0 0 0 0 0 0 0 0 2 0 0 0 11 13 3 3 3 3 3 3 3 3 3 3 3 3 3 3 3 3 3 3 3 3 3 3 3 3 3 3 15 0